NO ./north.xpm
SO ./south.xpm
WE ./west.xpm
EA ./east.xpm

C 225,30,0
F 10,100,0
1111111111111
1000000000001
1000000000001
1000000100001
1000000010001
1000000001001
1000000000001
1000000110001
1000000S10001
1000000000001
1000000000001
1111111111111
