NO ./test_file/north.xpm
SO ./test_file/south.xpm
WE ./test_file/west.xpm
EA ./test_file/east.xpm

C 225,30,0
F 10,0 ,0
1111111111111
1000000000001
1000000000001
1000000100001
1000000010001
1000000001001
1000000000001
1000000110001
1000000010001
1000000001001
10000000000N1
1111111111111
