NO ./test
SO ./test
WE ./test
EA ./test
F 10,100,0
C 225,30,0
1111111
1000101
10N1001
1111111