NO ./test
SO ./test
WE ./test
EA ./test
F 10,100,0
C 225,30,0
1111111111111
1000000000001
1000000000001
1000000100001
1000000010001
1000000001001
1000000000001
1000000110001
1000W00010001
1000000000001
1000000000001
1111111111111
